df_active_weather
id_weather	int64
status	int64
weather_description	string

df_cancellation
id_cancellation	int64
status	int64
cancellation_reason	string

df_carriers
id_carriers	int64
code	string
description	string

df_stations
id_airport	int64
airport_code	string
airport_name	string
airport_complete_name	string
us_state	category
us_state_abbr	category
latitude	float64
longitude	float64
elevation	int64
icao_code	string
iata_code	string
mesonet_code	string

df_departures
id_departure	int64
flight_date	datetime64[ns]
dep_hour	int64
mkt_carrier_fl_num	int64
op_carrier_fl_num	int64
dep_time	datetime64[ns]
crs_dep_time	datetime64[ns]
taxi_out	int64
dep_delay	int64
air_time	int64
distance	float64
wind_dir	float64
wind_speed	float64
wind_gust	float64
visibility	float64
temperature	float64
dew_point	float64
rel_humidity	float64
low_level_cloud	Boolean
mid_level_cloud	Boolean
high_level_cloud	Boolean
mkt_unique_carrier	string
op_unique_carrier	string
origin	string
dest	string
cancelled	int64
mesonet_station	string
active_weather	int64

df_aircraft
id_aircraft	int64
year_of_manufacture	int64
manufacturer	category
icao_type	string
range	category
width	category